,CLASS,PACKAGE,KILLED,,MEMORY_ERROR,SURVIVED,TIMED_OUT,Total_Mutant,Mutation_Score
0,AVLTree,org.apache.commons.math3.geometry.partitioning.utilities,100,0,6,21,0,127,78.74015748
1,Abs,org.apache.commons.math3.analysis.function,0,0,0,1,0,1,0
2,AbstractConvergenceChecker,org.apache.commons.math3.optim,2,0,0,0,0,2,100
3,AbstractConvergenceChecker,org.apache.commons.math3.optimization,2,0,0,0,0,2,100
4,AbstractConvexHullGenerator2D,org.apache.commons.math3.geometry.euclidean.twod.hull,5,0,0,1,0,6,83.33333333
5,AbstractCurveFitter,org.apache.commons.math3.fitting,13,0,0,0,0,13,100
6,AbstractDifferentiableOptimizer,org.apache.commons.math3.optimization.general,0,0,3,0,0,3,0
7,AbstractDifferentiableUnivariateSolver,org.apache.commons.math3.analysis.solvers,2,0,0,1,0,3,66.66666667
8,AbstractEvaluation,org.apache.commons.math3.fitting.leastsquares,10,0,0,0,0,10,100
9,AbstractFieldIntegrator,org.apache.commons.math3.ode,38,0,2,9,5,54,79.62962963
10,AbstractFieldMatrix,org.apache.commons.math3.linear,312,0,41,66,0,419,74.46300716
11,AbstractFieldStepInterpolator,org.apache.commons.math3.ode.sampling,7,0,0,0,0,7,100
12,AbstractFormat,org.apache.commons.math3.fraction,17,0,1,4,0,22,77.27272727
13,AbstractIntegerDistribution,org.apache.commons.math3.distribution,37,0,3,15,9,64,71.875
14,AbstractIntegrator,org.apache.commons.math3.ode,55,0,2,9,6,72,84.72222222
15,AbstractLeastSquaresOptimizer,org.apache.commons.math3.optim.nonlinear.vector.jacobian,25,1,1,0,0,27,96.2962963
16,AbstractLeastSquaresOptimizer,org.apache.commons.math3.optimization.general,40,1,3,6,0,50,82
17,AbstractLinearOptimizer,org.apache.commons.math3.optimization.linear,8,0,0,2,1,11,81.81818182
18,AbstractListChromosome,org.apache.commons.math3.genetics,3,0,0,2,0,5,60
19,AbstractMultipleLinearRegression,org.apache.commons.math3.stat.regression,53,0,1,7,0,61,86.8852459
20,AbstractMultivariateRealDistribution,org.apache.commons.math3.distribution,7,0,0,1,0,8,87.5
21,AbstractOptimizationProblem,org.apache.commons.math3.optim,3,0,0,0,0,3,100
22,AbstractParameterizable,org.apache.commons.math3.ode,4,0,1,0,0,5,80
23,AbstractPolynomialSolver,org.apache.commons.math3.analysis.solvers,2,0,0,0,0,2,100
24,AbstractRandomGenerator,org.apache.commons.math3.random,32,0,3,9,7,51,76.47058824
25,AbstractRealDistribution,org.apache.commons.math3.distribution,47,0,1,12,4,64,79.6875
26,AbstractRealMatrix,org.apache.commons.math3.linear,323,0,36,50,0,409,78.97310513
27,AbstractRegion,org.apache.commons.math3.geometry.partitioning,81,0,9,8,0,98,82.65306122
28,AbstractScalarDifferentiableOptimizer,org.apache.commons.math3.optimization.general,3,0,0,0,0,3,100
29,AbstractSimplex,org.apache.commons.math3.optim.nonlinear.scalar.noderiv,65,0,2,4,2,73,91.78082192
30,AbstractSimplex,org.apache.commons.math3.optimization.direct,65,0,2,4,2,73,91.78082192
31,AbstractStepInterpolator,org.apache.commons.math3.ode.sampling,61,0,5,4,0,70,87.14285714
32,AbstractStorelessUnivariateStatistic,org.apache.commons.math3.stat.descriptive,23,0,0,3,0,26,88.46153846
33,AbstractSubHyperplane,org.apache.commons.math3.geometry.partitioning,16,0,1,0,0,17,94.11764706
34,AbstractUnivariateDifferentiableSolver,org.apache.commons.math3.analysis.solvers,3,0,0,0,0,3,100
35,AbstractUnivariateStatistic,org.apache.commons.math3.stat.descriptive,8,0,12,0,0,20,40
36,AbstractWell,org.apache.commons.math3.random,37,0,0,2,1,40,95
37,Acos,org.apache.commons.math3.analysis.function,0,0,2,1,0,3,0
38,Acosh,org.apache.commons.math3.analysis.function,0,0,3,0,0,3,0
39,AdamsBashforthFieldIntegrator,org.apache.commons.math3.ode.nonstiff,23,0,1,14,9,47,68.08510638
40,AdamsBashforthIntegrator,org.apache.commons.math3.ode.nonstiff,44,0,6,19,13,82,69.51219512
41,AdamsFieldIntegrator,org.apache.commons.math3.ode.nonstiff,3,0,0,0,0,3,100
42,AdamsFieldStepInterpolator,org.apache.commons.math3.ode.nonstiff,11,0,1,2,0,14,78.57142857
43,AdamsIntegrator,org.apache.commons.math3.ode.nonstiff,3,0,0,0,0,3,100
44,AdamsMoultonFieldIntegrator,org.apache.commons.math3.ode.nonstiff,23,0,1,16,9,49,65.30612245
45,AdamsMoultonIntegrator,org.apache.commons.math3.ode.nonstiff,41,0,6,22,17,86,67.44186047
46,AdamsNordsieckFieldTransformer,org.apache.commons.math3.ode.nonstiff,50,0,0,14,0,64,78.125
47,AdamsNordsieckTransformer,org.apache.commons.math3.ode.nonstiff,82,0,1,0,0,83,98.79518072
48,AdaptiveStepsizeFieldIntegrator,org.apache.commons.math3.ode.nonstiff,21,0,9,13,3,46,52.17391304
49,AdaptiveStepsizeIntegrator,org.apache.commons.math3.ode.nonstiff,46,0,2,15,14,77,77.92207792
50,Add,org.apache.commons.math3.analysis.function,2,0,0,0,0,2,100
51,AggregateSummaryStatistics,org.apache.commons.math3.stat.descriptive,36,0,18,6,0,60,60
52,AgrestiCoullInterval,org.apache.commons.math3.stat.interval,17,0,0,0,0,17,100
53,AkimaSplineInterpolator,org.apache.commons.math3.analysis.interpolation,94,0,0,6,0,100,94
54,AklToussaintHeuristic,org.apache.commons.math3.geometry.euclidean.twod.hull,16,0,2,22,0,40,40
55,Arc,org.apache.commons.math3.geometry.spherical.oned,26,0,1,7,0,34,76.47058824
56,ArcsSet,org.apache.commons.math3.geometry.spherical.oned,139,0,21,42,14,216,70.83333333
57,ArgUtils,org.apache.commons.math3.exception.util,6,0,0,0,0,6,100
58,ArithmeticUtils,org.apache.commons.math3.util,145,0,17,24,27,213,80.75117371
59,Array2DRowFieldMatrix,org.apache.commons.math3.linear,133,0,8,32,0,173,76.87861272
60,Array2DRowRealMatrix,org.apache.commons.math3.linear,154,0,0,29,0,183,84.15300546
61,ArrayFieldVector,org.apache.commons.math3.linear,145,0,32,81,0,258,56.20155039
62,ArrayRealVector,org.apache.commons.math3.linear,254,0,5,35,0,294,86.39455782
63,Asin,org.apache.commons.math3.analysis.function,0,0,2,1,0,3,0
64,Asinh,org.apache.commons.math3.analysis.function,0,0,3,0,0,3,0
65,Atan,org.apache.commons.math3.analysis.function,0,0,2,1,0,3,0
66,Atan2,org.apache.commons.math3.analysis.function,0,0,1,0,0,1,0
67,Atanh,org.apache.commons.math3.analysis.function,0,0,3,0,0,3,0
68,BOBYQAOptimizer,org.apache.commons.math3.optim.nonlinear.scalar.noderiv,1016,0,175,357,15,1563,65.96289187
69,BOBYQAOptimizer,org.apache.commons.math3.optimization.direct,1017,0,175,358,13,1563,65.89891235
70,BSPTree,org.apache.commons.math3.geometry.partitioning,82,0,6,28,0,116,70.68965517
71,BaseAbstractMultivariateOptimizer,org.apache.commons.math3.optimization.direct,44,0,0,1,0,45,97.77777778
72,BaseAbstractMultivariateSimpleBoundsOptimizer,org.apache.commons.math3.optimization.direct,2,0,0,0,0,2,100
73,BaseAbstractMultivariateVectorOptimizer,org.apache.commons.math3.optimization.direct,20,0,11,1,0,32,62.5
74,BaseAbstractUnivariateIntegrator,org.apache.commons.math3.analysis.integration,15,0,0,3,1,19,84.21052632
75,BaseAbstractUnivariateOptimizer,org.apache.commons.math3.optimization.univariate,18,0,0,0,0,18,100
76,BaseAbstractUnivariateSolver,org.apache.commons.math3.analysis.solvers,22,0,1,1,0,24,91.66666667
77,BaseMultiStartMultivariateOptimizer,org.apache.commons.math3.optim,24,0,0,7,3,34,79.41176471
78,BaseMultivariateMultiStartOptimizer,org.apache.commons.math3.optimization,15,0,4,7,0,26,57.69230769
79,BaseMultivariateOptimizer,org.apache.commons.math3.optim,25,0,0,1,0,26,96.15384615
80,BaseMultivariateVectorMultiStartOptimizer,org.apache.commons.math3.optimization,14,0,2,16,0,32,43.75
81,BaseOptimizer,org.apache.commons.math3.optim,14,0,4,0,0,18,77.77777778
82,BaseRuleFactory,org.apache.commons.math3.analysis.integration.gauss,8,0,0,3,2,13,76.92307692
83,BaseSecantSolver,org.apache.commons.math3.analysis.solvers,40,0,0,15,0,55,72.72727273
84,BesselJ,org.apache.commons.math3.special,240,0,12,115,1,368,65.48913043
85,Beta,org.apache.commons.math3.special,227,0,5,26,5,263,88.21292776
86,BetaDistribution,org.apache.commons.math3.distribution,106,0,9,22,5,142,78.16901408
87,BiDiagonalTransformer,org.apache.commons.math3.linear,213,0,3,9,0,225,94.66666667
88,BicubicInterpolatingFunction,org.apache.commons.math3.analysis.interpolation,110,0,0,0,0,110,100
89,BicubicInterpolator,org.apache.commons.math3.analysis.interpolation,35,0,0,6,1,42,85.71428571
90,BicubicSplineInterpolatingFunction,org.apache.commons.math3.analysis.interpolation,116,0,8,32,0,156,74.35897436
91,BicubicSplineInterpolator,org.apache.commons.math3.analysis.interpolation,36,0,0,18,0,54,66.66666667
92,BigFraction,org.apache.commons.math3.fraction,161,0,18,23,1,203,79.80295567
93,BigFractionField,org.apache.commons.math3.fraction,5,0,0,0,0,5,100
94,BigFractionFormat,org.apache.commons.math3.fraction,27,0,4,6,0,37,72.97297297
95,BigReal,org.apache.commons.math3.util,15,0,2,2,0,19,78.94736842
96,BigRealField,org.apache.commons.math3.util,4,0,1,0,0,5,80
97,BinaryChromosome,org.apache.commons.math3.genetics,14,0,1,1,1,17,88.23529412
98,BinaryMutation,org.apache.commons.math3.genetics,3,0,0,0,0,3,100
99,BinomialDistribution,org.apache.commons.math3.distribution,39,0,1,0,0,40,97.5
100,BinomialTest,org.apache.commons.math3.stat.inference,21,0,4,8,2,35,65.71428571
101,BisectionSolver,org.apache.commons.math3.analysis.solvers,5,0,0,3,0,8,62.5
102,BitsStreamGenerator,org.apache.commons.math3.random,42,0,23,9,3,77,58.44155844
103,BlockFieldMatrix,org.apache.commons.math3.linear,742,0,103,96,0,941,78.8522848
104,BlockRealMatrix,org.apache.commons.math3.linear,872,0,39,99,0,1010,86.33663366
105,BoundaryAttribute,org.apache.commons.math3.geometry.partitioning,3,0,0,0,0,3,100
106,BoundaryBuilder,org.apache.commons.math3.geometry.partitioning,13,0,0,1,0,14,92.85714286
107,BoundaryProjection,org.apache.commons.math3.geometry.partitioning,3,0,0,0,0,3,100
108,BoundaryProjector,org.apache.commons.math3.geometry.partitioning,22,0,0,3,0,25,88
109,BoundarySizeVisitor,org.apache.commons.math3.geometry.partitioning,6,0,0,0,0,6,100
110,BracketFinder,org.apache.commons.math3.optim.univariate,52,0,9,28,0,89,58.42696629
111,BracketFinder,org.apache.commons.math3.optimization.univariate,27,0,15,49,0,91,29.67032967
112,BracketingNthOrderBrentSolver,org.apache.commons.math3.analysis.solvers,118,0,0,25,1,144,82.63888889
113,BracketingNthOrderBrentSolverDFP,org.apache.commons.math3.dfp,5,0,1,1,0,7,71.42857143
114,BrentOptimizer,org.apache.commons.math3.optim.univariate,95,0,2,18,0,115,82.60869565
115,BrentOptimizer,org.apache.commons.math3.optimization.univariate,94,0,2,19,0,115,81.73913043
116,BrentSolver,org.apache.commons.math3.analysis.solvers,63,0,0,23,0,86,73.25581395
117,CMAESOptimizer,org.apache.commons.math3.optim.nonlinear.scalar.noderiv,291,0,49,145,0,485,60
118,CMAESOptimizer,org.apache.commons.math3.optimization.direct,283,0,51,148,0,482,58.71369295
119,CanberraDistance,org.apache.commons.math3.ml.distance,9,0,0,1,0,10,90
120,CardanEulerSingularityException,org.apache.commons.math3.geometry.euclidean.threed,0,0,0,1,0,1,0
121,CauchyDistribution,org.apache.commons.math3.distribution,30,0,2,3,0,35,85.71428571
122,Cbrt,org.apache.commons.math3.analysis.function,0,0,2,1,0,3,0
123,Ceil,org.apache.commons.math3.analysis.function,0,0,0,1,0,1,0
124,CentralPivotingStrategy,org.apache.commons.math3.util,0,0,5,0,0,5,0
125,CentroidCluster,org.apache.commons.math3.ml.clustering,1,0,0,0,0,1,100
126,Characterization,org.apache.commons.math3.geometry.partitioning,26,0,0,0,0,26,100
127,ChebyshevDistance,org.apache.commons.math3.ml.distance,1,0,0,0,0,1,100
128,ChiSquareTest,org.apache.commons.math3.stat.inference,105,0,0,16,0,121,86.7768595
129,ChiSquaredDistribution,org.apache.commons.math3.distribution,13,0,0,1,1,15,93.33333333
130,CholeskyDecomposition,org.apache.commons.math3.linear,92,0,2,2,0,96,95.83333333
131,Chromosome,org.apache.commons.math3.genetics,7,0,1,0,0,8,87.5
132,ChromosomePair,org.apache.commons.math3.genetics,2,0,1,0,0,3,66.66666667
133,Circle,org.apache.commons.math3.geometry.spherical.twod,30,0,1,1,0,32,93.75
134,ClassicalRungeKuttaFieldIntegrator,org.apache.commons.math3.ode.nonstiff,7,0,0,0,0,7,100
135,ClassicalRungeKuttaFieldStepInterpolator,org.apache.commons.math3.ode.nonstiff,4,0,0,1,0,5,80
136,ClassicalRungeKuttaStepInterpolator,org.apache.commons.math3.ode.nonstiff,69,0,0,1,0,70,98.57142857
137,ClopperPearsonInterval,org.apache.commons.math3.stat.interval,26,0,0,4,0,30,86.66666667
138,Cluster,org.apache.commons.math3.ml.clustering,1,0,0,0,0,1,100
139,Cluster,org.apache.commons.math3.stat.clustering,2,0,0,0,0,2,100
140,ClusterEvaluator,org.apache.commons.math3.ml.clustering.evaluation,13,0,1,2,0,16,81.25
141,Clusterer,org.apache.commons.math3.ml.clustering,2,0,0,0,0,2,100
142,Combinations,org.apache.commons.math3.util,63,0,0,4,0,67,94.02985075
143,CombinatoricsUtils,org.apache.commons.math3.util,132,0,3,35,4,174,78.16091954
144,Complex,org.apache.commons.math3.complex,278,0,8,20,1,307,90.87947883
145,ComplexField,org.apache.commons.math3.complex,4,0,1,0,0,5,80
146,ComplexFormat,org.apache.commons.math3.complex,31,0,14,6,0,51,60.78431373
147,ComplexUtils,org.apache.commons.math3.complex,8,0,0,0,0,8,100
148,CompositeFormat,org.apache.commons.math3.util,35,0,0,5,0,40,87.5
149,ConfidenceInterval,org.apache.commons.math3.stat.interval,5,0,1,5,0,11,45.45454545
150,ConjugateGradient,org.apache.commons.math3.linear,19,0,3,11,1,34,58.82352941
151,Constant,org.apache.commons.math3.analysis.function,2,0,1,0,0,3,66.66666667
152,ConstantRealDistribution,org.apache.commons.math3.distribution,15,0,1,2,0,18,83.33333333
153,ContinuedFraction,org.apache.commons.math3.util,15,0,2,3,4,24,79.16666667
154,ContinuousOutputFieldModel,org.apache.commons.math3.ode,40,0,1,28,4,73,60.2739726
155,ContinuousOutputModel,org.apache.commons.math3.ode,44,0,2,58,4,108,44.44444444
156,ConvergenceException,org.apache.commons.math3.exception,0,0,0,1,0,1,0
157,ConvexHull2D,org.apache.commons.math3.geometry.euclidean.twod.hull,32,0,0,1,0,33,96.96969697
158,CorrelatedRandomVectorGenerator,org.apache.commons.math3.random,12,0,4,1,0,17,70.58823529
159,Cos,org.apache.commons.math3.analysis.function,2,0,1,0,0,3,66.66666667
160,Cosh,org.apache.commons.math3.analysis.function,1,0,1,1,0,3,33.33333333
161,Covariance,org.apache.commons.math3.stat.correlation,35,0,1,3,0,39,89.74358974
162,CurveFitter,org.apache.commons.math3.fitting,12,0,0,0,0,12,100
163,CurveFitter,org.apache.commons.math3.optimization.fitting,11,0,9,0,0,20,55
164,CycleCrossover,org.apache.commons.math3.genetics,11,1,1,2,7,22,86.36363636
165,DBSCANClusterer,org.apache.commons.math3.ml.clustering,23,0,0,3,0,26,88.46153846
166,DBSCANClusterer,org.apache.commons.math3.stat.clustering,23,0,0,3,0,26,88.46153846
167,DSCompiler,org.apache.commons.math3.analysis.differentiation,683,0,0,29,0,712,95.92696629
168,Decimal64,org.apache.commons.math3.util,89,0,9,1,0,99,89.8989899
169,Decimal64Field,org.apache.commons.math3.util,4,0,0,0,0,4,100
170,DefaultFieldMatrixChangingVisitor,org.apache.commons.math3.linear,0,0,1,1,0,2,0
171,DefaultFieldMatrixPreservingVisitor,org.apache.commons.math3.linear,0,0,0,1,0,1,0
172,DefaultIterativeLinearSolverEvent,org.apache.commons.math3.linear,5,0,3,0,0,8,62.5
173,DefaultMeasurementModel,org.apache.commons.math3.filter,2,0,0,0,0,2,100
174,DefaultProcessModel,org.apache.commons.math3.filter,5,0,0,0,0,5,100
175,DefaultRealMatrixChangingVisitor,org.apache.commons.math3.linear,0,0,1,1,0,2,0
176,DefaultRealMatrixPreservingVisitor,org.apache.commons.math3.linear,0,0,0,1,0,1,0
177,DefaultTransformer,org.apache.commons.math3.util,6,0,1,1,0,8,75
178,DenseWeightedEvaluation,org.apache.commons.math3.fitting.leastsquares,3,0,0,0,0,3,100
179,DerivativeStructure,org.apache.commons.math3.analysis.differentiation,184,0,0,30,0,214,85.98130841
180,DescriptiveStatistics,org.apache.commons.math3.stat.descriptive,55,0,1,8,0,64,85.9375
181,Dfp,org.apache.commons.math3.dfp,1077,0,48,29,7,1161,93.36778639
182,DfpDec,org.apache.commons.math3.dfp,112,0,13,10,1,136,83.08823529
183,DfpField,org.apache.commons.math3.dfp,49,0,10,28,2,89,57.30337079
184,DfpMath,org.apache.commons.math3.dfp,144,0,36,15,7,202,74.75247525
185,DiagonalMatrix,org.apache.commons.math3.linear,62,0,0,8,0,70,88.57142857
186,DimensionMismatchException,org.apache.commons.math3.exception,1,0,0,0,0,1,100
187,DiskGenerator,org.apache.commons.math3.geometry.euclidean.twod,12,0,0,0,0,12,100
188,Divide,org.apache.commons.math3.analysis.function,2,0,0,0,0,2,100
189,DividedDifferenceInterpolator,org.apache.commons.math3.analysis.interpolation,16,0,0,0,0,16,100
190,DormandPrince54FieldIntegrator,org.apache.commons.math3.ode.nonstiff,12,0,0,0,1,13,100
191,DormandPrince54FieldStepInterpolator,org.apache.commons.math3.ode.nonstiff,4,0,0,1,0,5,80
192,DormandPrince54Integrator,org.apache.commons.math3.ode.nonstiff,24,0,0,0,2,26,100
193,DormandPrince54StepInterpolator,org.apache.commons.math3.ode.nonstiff,74,0,0,2,1,77,97.4025974
194,DormandPrince853FieldIntegrator,org.apache.commons.math3.ode.nonstiff,13,0,0,1,1,15,93.33333333
195,DormandPrince853FieldStepInterpolator,org.apache.commons.math3.ode.nonstiff,9,0,0,1,0,10,90
196,DormandPrince853Integrator,org.apache.commons.math3.ode.nonstiff,29,0,0,1,23,53,98.11320755
197,DormandPrince853StepInterpolator,org.apache.commons.math3.ode.nonstiff,250,0,0,5,1,256,98.046875
198,DoublePoint,org.apache.commons.math3.ml.clustering,4,0,2,2,0,8,50
199,DummyLocalizable,org.apache.commons.math3.exception.util,0,0,3,0,0,3,0
200,DummyStepHandler,org.apache.commons.math3.ode.sampling,0,0,2,0,0,2,0
201,EarthMoversDistance,org.apache.commons.math3.ml.distance,6,0,0,1,0,7,85.71428571
202,Edge,org.apache.commons.math3.geometry.spherical.twod,19,0,3,18,0,40,47.5
203,EdgesBuilder,org.apache.commons.math3.geometry.spherical.twod,16,0,0,4,0,20,80
204,EigenDecomposition,org.apache.commons.math3.linear,401,0,22,49,2,474,85.02109705
205,ElitisticListPopulation,org.apache.commons.math3.genetics,11,0,0,3,0,14,78.57142857
206,EmbeddedRungeKuttaFieldIntegrator,org.apache.commons.math3.ode.nonstiff,42,0,3,19,10,74,70.27027027
207,EmbeddedRungeKuttaIntegrator,org.apache.commons.math3.ode.nonstiff,85,0,0,10,14,109,90.82568807
208,EmpiricalDistribution,org.apache.commons.math3.random,112,0,9,21,0,142,78.87323944
209,EnclosingBall,org.apache.commons.math3.geometry.enclosing,12,0,0,1,0,13,92.30769231
210,EnumeratedDistribution,org.apache.commons.math3.distribution,30,0,12,7,0,49,61.2244898
211,EnumeratedIntegerDistribution,org.apache.commons.math3.distribution,32,0,0,4,0,36,88.88888889
212,EnumeratedRealDistribution,org.apache.commons.math3.distribution,44,0,0,4,0,48,91.66666667
213,EquationsMapper,org.apache.commons.math3.ode,6,0,0,0,0,6,100
214,Erf,org.apache.commons.math3.special,143,0,0,24,0,167,85.62874251
215,Euclidean1D,org.apache.commons.math3.geometry.euclidean.oned,3,0,0,0,0,3,100
216,Euclidean2D,org.apache.commons.math3.geometry.euclidean.twod,4,0,0,0,0,4,100
217,Euclidean3D,org.apache.commons.math3.geometry.euclidean.threed,4,0,0,0,0,4,100
218,EuclideanDistance,org.apache.commons.math3.ml.distance,1,0,0,0,0,1,100
219,EuclideanDoublePoint,org.apache.commons.math3.stat.clustering,11,0,2,1,0,14,78.57142857
220,EuclideanIntegerPoint,org.apache.commons.math3.stat.clustering,11,0,2,1,0,14,78.57142857
221,EulerFieldIntegrator,org.apache.commons.math3.ode.nonstiff,4,0,0,0,0,4,100
222,EulerFieldStepInterpolator,org.apache.commons.math3.ode.nonstiff,2,0,0,3,0,5,40
223,EulerStepInterpolator,org.apache.commons.math3.ode.nonstiff,13,0,0,2,0,15,86.66666667
224,EvaluationRmsChecker,org.apache.commons.math3.fitting.leastsquares,4,0,0,0,0,4,100
225,EventFilter,org.apache.commons.math3.ode.events,25,0,4,11,0,40,62.5
226,EventState,org.apache.commons.math3.ode.events,78,0,6,13,3,100,81
227,ExceptionContext,org.apache.commons.math3.exception.util,45,0,1,0,0,46,97.82608696
228,Exp,org.apache.commons.math3.analysis.function,0,0,2,1,0,3,0
229,ExpandableStatefulODE,org.apache.commons.math3.ode,32,0,4,0,0,36,88.88888889
230,Expm1,org.apache.commons.math3.analysis.function,1,0,2,0,0,3,33.33333333
231,ExponentialDecayFunction,org.apache.commons.math3.ml.neuralnet.sofm.util,14,0,0,1,0,15,93.33333333
232,ExponentialDistribution,org.apache.commons.math3.distribution,45,0,2,7,2,56,83.92857143
233,FDistribution,org.apache.commons.math3.distribution,56,0,0,4,1,61,93.44262295
234,FastCosineTransformer,org.apache.commons.math3.transform,57,0,0,1,0,58,98.27586207
235,FastFourierTransformer,org.apache.commons.math3.transform,194,0,6,3,1,204,95.58823529
236,FastHadamardTransformer,org.apache.commons.math3.transform,43,0,1,0,2,46,97.82608696
237,FastMath,org.apache.commons.math3.util,2129,0,42,334,12,2517,85.06158125
238,FastMathCalc,org.apache.commons.math3.util,0,0,245,0,0,245,0
239,FastMathLiteralArrays,org.apache.commons.math3.util,4,0,0,1,0,5,80
240,FastSineTransformer,org.apache.commons.math3.transform,42,0,0,1,0,43,97.6744186
241,FeatureInitializerFactory,org.apache.commons.math3.ml.neuralnet,5,0,1,2,0,8,62.5
242,FieldBracketingNthOrderBrentSolver,org.apache.commons.math3.analysis.solvers,82,0,5,29,1,117,70.94017094
243,FieldEquationsMapper,org.apache.commons.math3.ode,53,0,0,3,0,56,94.64285714
244,FieldEventState,org.apache.commons.math3.ode.events,27,0,24,17,3,71,42.25352113
245,FieldExpandableODE,org.apache.commons.math3.ode,14,0,0,1,0,15,93.33333333
246,FieldHermiteInterpolator,org.apache.commons.math3.analysis.interpolation,46,0,0,4,0,50,92
247,FieldLUDecomposition,org.apache.commons.math3.linear,144,0,0,5,0,149,96.6442953
248,FieldODEState,org.apache.commons.math3.ode,16,0,0,0,0,16,100
249,FieldODEStateAndDerivative,org.apache.commons.math3.ode,4,0,0,0,0,4,100
250,FieldRotation,org.apache.commons.math3.geometry.euclidean.threed,173,0,0,78,0,251,68.92430279
251,FieldStepNormalizer,org.apache.commons.math3.ode.sampling,0,0,28,0,0,28,0
252,FieldVector3D,org.apache.commons.math3.geometry.euclidean.threed,136,0,0,29,0,165,82.42424242
253,FilterType,org.apache.commons.math3.ode.events,75,0,0,21,0,96,78.125
254,FiniteDifferencesDifferentiator,org.apache.commons.math3.analysis.differentiation,82,0,0,7,0,89,92.13483146
255,FirstMoment,org.apache.commons.math3.stat.descriptive.moment,9,0,1,3,0,13,69.23076923
256,FirstOrderConverter,org.apache.commons.math3.ode,7,0,0,0,0,7,100
257,FixedElapsedTime,org.apache.commons.math3.genetics,5,0,0,3,1,9,66.66666667
258,FixedGenerationCount,org.apache.commons.math3.genetics,5,0,1,1,1,8,75
259,Floor,org.apache.commons.math3.analysis.function,0,0,0,1,0,1,0
260,FourthMoment,org.apache.commons.math3.stat.descriptive.moment,24,0,1,2,0,27,88.88888889
261,Fraction,org.apache.commons.math3.fraction,121,0,2,19,1,143,85.31468531
262,FractionField,org.apache.commons.math3.fraction,5,0,0,0,0,5,100
263,FractionFormat,org.apache.commons.math3.fraction,18,0,5,5,0,28,64.28571429
264,Frequency,org.apache.commons.math3.stat,71,0,10,5,0,86,82.55813953
265,FunctionUtils,org.apache.commons.math3.analysis,133,0,60,3,0,196,67.85714286
266,FuzzyKMeansClusterer,org.apache.commons.math3.ml.clustering,48,0,14,12,11,85,69.41176471
267,GLSMultipleLinearRegression,org.apache.commons.math3.stat.regression,8,0,3,1,0,12,66.66666667
268,GTest,org.apache.commons.math3.stat.inference,94,0,0,10,0,104,90.38461538
269,Gamma,org.apache.commons.math3.special,275,0,3,42,4,324,86.11111111
270,GammaDistribution,org.apache.commons.math3.distribution,100,0,14,33,2,149,68.45637584
271,GaussIntegrator,org.apache.commons.math3.analysis.integration.gauss,12,0,0,0,0,12,100
272,GaussIntegratorFactory,org.apache.commons.math3.analysis.integration.gauss,15,0,0,0,0,15,100
273,GaussNewtonOptimizer,org.apache.commons.math3.fitting.leastsquares,32,0,3,2,2,39,87.17948718
274,GaussNewtonOptimizer,org.apache.commons.math3.optim.nonlinear.vector.jacobian,36,0,0,0,0,36,100
275,GaussNewtonOptimizer,org.apache.commons.math3.optimization.general,32,0,0,0,0,32,100
276,Gaussian,org.apache.commons.math3.analysis.function,66,0,1,4,0,71,92.95774648
277,GaussianCurveFitter,org.apache.commons.math3.fitting,57,0,19,18,0,94,60.63829787
278,GaussianFitter,org.apache.commons.math3.fitting,53,0,19,18,0,90,58.88888889
279,GaussianFitter,org.apache.commons.math3.optimization.fitting,53,0,19,18,0,90,58.88888889
280,GaussianRandomGenerator,org.apache.commons.math3.random,1,0,0,0,0,1,100
281,GeneticAlgorithm,org.apache.commons.math3.genetics,17,0,0,12,0,29,58.62068966
282,GeometricDistribution,org.apache.commons.math3.distribution,43,0,2,2,0,47,91.4893617
283,GeometricMean,org.apache.commons.math3.stat.descriptive.moment,13,0,2,5,0,20,65
284,GillFieldIntegrator,org.apache.commons.math3.ode.nonstiff,7,0,0,0,0,7,100
285,GillFieldStepInterpolator,org.apache.commons.math3.ode.nonstiff,5,0,0,0,0,5,100
286,GillStepInterpolator,org.apache.commons.math3.ode.nonstiff,76,0,0,0,0,76,100
287,GradientFunction,org.apache.commons.math3.analysis.differentiation,5,0,0,0,0,5,100
288,GradientMultivariateOptimizer,org.apache.commons.math3.optim.nonlinear.scalar,4,0,0,0,0,4,100
289,GraggBulirschStoerIntegrator,org.apache.commons.math3.ode.nonstiff,274,0,3,89,48,414,77.77777778
290,GraggBulirschStoerStepInterpolator,org.apache.commons.math3.ode.nonstiff,153,0,6,16,10,185,88.10810811
291,GumbelDistribution,org.apache.commons.math3.distribution,26,0,8,5,0,39,66.66666667
292,HaltonSequenceGenerator,org.apache.commons.math3.random,24,0,0,1,2,27,96.2962963
293,HarmonicCurveFitter,org.apache.commons.math3.fitting,70,0,1,28,0,99,70.70707071
294,HarmonicFitter,org.apache.commons.math3.fitting,67,0,0,28,0,95,70.52631579
295,HarmonicFitter,org.apache.commons.math3.optimization.fitting,67,0,0,28,0,95,70.52631579
296,HarmonicOscillator,org.apache.commons.math3.analysis.function,34,0,1,0,0,35,97.14285714
297,HermiteInterpolator,org.apache.commons.math3.analysis.interpolation,53,0,0,3,0,56,94.64285714
298,HermiteRuleFactory,org.apache.commons.math3.analysis.integration.gauss,70,0,0,0,1,71,100
299,HessenbergTransformer,org.apache.commons.math3.linear,104,0,1,4,0,109,95.41284404
300,HighamHall54FieldIntegrator,org.apache.commons.math3.ode.nonstiff,13,0,0,0,2,15,100
301,HighamHall54FieldStepInterpolator,org.apache.commons.math3.ode.nonstiff,4,0,0,1,0,5,80
302,HighamHall54Integrator,org.apache.commons.math3.ode.nonstiff,10,0,0,1,9,20,95
303,HighamHall54StepInterpolator,org.apache.commons.math3.ode.nonstiff,144,0,0,1,0,145,99.31034483
304,HitHistogram,org.apache.commons.math3.ml.neuralnet.twod.util,0,0,11,0,0,11,0
305,HypergeometricDistribution,org.apache.commons.math3.distribution,62,0,1,1,2,66,96.96969697
306,ISAACRandom,org.apache.commons.math3.random,143,0,4,5,3,155,94.19354839
307,Identity,org.apache.commons.math3.analysis.function,2,0,1,0,0,3,66.66666667
308,Incrementor,org.apache.commons.math3.util,15,0,4,3,0,22,68.18181818
309,InitialGuess,org.apache.commons.math3.optim,1,0,0,0,0,1,100
310,InitialGuess,org.apache.commons.math3.optimization,1,0,0,0,0,1,100
311,InsideFinder,org.apache.commons.math3.geometry.partitioning,0,0,29,0,0,29,0
312,IntegerSequence,org.apache.commons.math3.util,31,0,1,3,6,41,90.24390244
313,InterpolatingMicrosphere,org.apache.commons.math3.analysis.interpolation,45,0,2,13,0,60,75
314,InterpolatingMicrosphere2D,org.apache.commons.math3.analysis.interpolation,6,0,1,0,0,7,85.71428571
315,Interval,org.apache.commons.math3.geometry.euclidean.oned,20,0,4,4,0,28,71.42857143
316,IntervalUtils,org.apache.commons.math3.stat.interval,10,0,0,4,0,14,71.42857143
317,IntervalsSet,org.apache.commons.math3.geometry.euclidean.oned,84,0,11,17,13,125,77.6
318,Inverse,org.apache.commons.math3.analysis.function,3,0,1,0,0,4,75
319,IterationEvent,org.apache.commons.math3.util,1,0,0,0,0,1,100
320,IterationManager,org.apache.commons.math3.util,4,0,2,1,1,8,62.5
321,IterativeLegendreGaussIntegrator,org.apache.commons.math3.analysis.integration,26,0,0,2,0,28,92.85714286
322,IterativeLinearSolver,org.apache.commons.math3.linear,4,0,6,3,0,13,30.76923077
323,IterativeLinearSolverEvent,org.apache.commons.math3.linear,0,0,1,0,0,1,0
324,JDKRandomGenerator,org.apache.commons.math3.random,2,0,1,0,0,3,66.66666667
325,JacobiPreconditioner,org.apache.commons.math3.linear,15,0,2,1,0,18,83.33333333
326,JacobianFunction,org.apache.commons.math3.analysis.differentiation,8,0,0,0,0,8,100
327,JacobianMatrices,org.apache.commons.math3.ode,79,0,4,11,0,94,84.04255319
328,JacobianMultivariateVectorOptimizer,org.apache.commons.math3.optim.nonlinear.vector,4,0,0,0,0,4,100
329,KMeansPlusPlusClusterer,org.apache.commons.math3.ml.clustering,38,0,27,24,0,89,42.69662921
330,KMeansPlusPlusClusterer,org.apache.commons.math3.stat.clustering,47,0,5,33,3,88,56.81818182
331,KalmanFilter,org.apache.commons.math3.filter,20,0,3,11,0,34,58.82352941
332,KendallsCorrelation,org.apache.commons.math3.stat.correlation,82,0,0,3,1,86,96.51162791
333,KohonenTrainingTask,org.apache.commons.math3.ml.neuralnet.sofm,2,0,0,0,0,2,100
334,KohonenUpdateAction,org.apache.commons.math3.ml.neuralnet.sofm,6,0,1,2,4,13,76.92307692
335,KolmogorovSmirnovDistribution,org.apache.commons.math3.distribution,71,0,15,16,4,106,70.75471698
336,KolmogorovSmirnovTest,org.apache.commons.math3.stat.inference,369,0,77,63,10,519,73.02504817
337,KthSelector,org.apache.commons.math3.util,33,0,0,13,5,51,74.50980392
338,Kurtosis,org.apache.commons.math3.stat.descriptive.moment,57,0,1,6,0,64,89.0625
339,LUDecomposition,org.apache.commons.math3.linear,137,0,0,3,0,140,97.85714286
340,LaguerreSolver,org.apache.commons.math3.analysis.solvers,49,0,8,22,1,80,62.5
341,LaplaceDistribution,org.apache.commons.math3.distribution,28,0,6,13,0,47,59.57446809
342,LearningFactorFunctionFactory,org.apache.commons.math3.ml.neuralnet.sofm,12,0,0,0,0,12,100
343,LeastSquaresAdapter,org.apache.commons.math3.fitting.leastsquares,7,0,0,0,0,7,100
344,LeastSquaresBuilder,org.apache.commons.math3.fitting.leastsquares,13,0,1,0,0,14,92.85714286
345,LeastSquaresConverter,org.apache.commons.math3.optim.nonlinear.scalar,18,0,0,0,0,18,100
346,LeastSquaresConverter,org.apache.commons.math3.optimization,18,0,0,0,0,18,100
347,LeastSquaresFactory,org.apache.commons.math3.fitting.leastsquares,30,1,8,2,0,41,75.6097561
348,LegendreGaussIntegrator,org.apache.commons.math3.analysis.integration,28,0,0,3,0,31,90.32258065
349,LegendreHighPrecisionRuleFactory,org.apache.commons.math3.analysis.integration.gauss,1,0,0,37,0,38,2.631578947
350,LegendreRuleFactory,org.apache.commons.math3.analysis.integration.gauss,73,0,0,0,0,73,100
351,LevenbergMarquardtOptimizer,org.apache.commons.math3.fitting.leastsquares,350,0,7,44,0,401,87.28179551
352,LevenbergMarquardtOptimizer,org.apache.commons.math3.optim.nonlinear.vector.jacobian,342,0,3,46,1,392,87.5
353,LevenbergMarquardtOptimizer,org.apache.commons.math3.optimization.general,337,0,3,48,1,389,86.88946015
354,LevyDistribution,org.apache.commons.math3.distribution,34,0,5,5,0,44,77.27272727
355,LimitAngle,org.apache.commons.math3.geometry.spherical.oned,14,0,1,1,0,16,87.5
356,Line,org.apache.commons.math3.geometry.euclidean.threed,34,0,4,8,0,46,73.91304348
357,Line,org.apache.commons.math3.geometry.euclidean.twod,72,0,13,18,0,103,69.90291262
358,LineSearch,org.apache.commons.math3.optim.nonlinear.scalar,8,0,0,0,0,8,100
359,LinearConstraint,org.apache.commons.math3.optim.linear,14,0,7,3,0,24,58.33333333
360,LinearConstraint,org.apache.commons.math3.optimization.linear,12,0,10,2,0,24,50
361,LinearConstraintSet,org.apache.commons.math3.optim.linear,1,0,0,0,0,1,100
362,LinearInterpolator,org.apache.commons.math3.analysis.interpolation,16,0,0,1,0,17,94.11764706
363,LinearObjectiveFunction,org.apache.commons.math3.optim.linear,13,0,4,2,0,19,68.42105263
364,LinearObjectiveFunction,org.apache.commons.math3.optimization.linear,12,0,6,2,0,20,60
365,LinearOptimizer,org.apache.commons.math3.optim.linear,8,0,0,0,0,8,100
366,ListPopulation,org.apache.commons.math3.genetics,18,0,4,5,0,27,66.66666667
367,LocalizedFormats,org.apache.commons.math3.exception.util,3,0,0,1,0,4,75
368,LocationFinder,org.apache.commons.math3.ml.neuralnet.twod.util,10,0,0,0,0,10,100
369,LoessInterpolator,org.apache.commons.math3.analysis.interpolation,102,0,2,13,1,118,87.28813559
370,Log,org.apache.commons.math3.analysis.function,2,0,1,0,0,3,66.66666667
371,Log10,org.apache.commons.math3.analysis.function,0,0,2,1,0,3,0
372,Log1p,org.apache.commons.math3.analysis.function,0,0,2,1,0,3,0
373,LogNormalDistribution,org.apache.commons.math3.distribution,64,0,0,10,1,75,86.66666667
374,Logistic,org.apache.commons.math3.analysis.function,36,0,1,5,0,42,85.71428571
375,LogisticDistribution,org.apache.commons.math3.distribution,31,0,7,6,0,44,70.45454545
376,Logit,org.apache.commons.math3.analysis.function,41,0,1,5,0,47,87.23404255
377,LutherFieldIntegrator,org.apache.commons.math3.ode.nonstiff,7,0,0,0,0,7,100
378,LutherFieldStepInterpolator,org.apache.commons.math3.ode.nonstiff,3,0,0,2,0,5,60
379,LutherStepInterpolator,org.apache.commons.math3.ode.nonstiff,254,0,0,10,0,264,96.21212121
380,ManhattanDistance,org.apache.commons.math3.ml.distance,1,0,0,0,0,1,100
381,MannWhitneyUTest,org.apache.commons.math3.stat.inference,30,0,0,3,0,33,90.90909091
382,MapUtils,org.apache.commons.math3.ml.neuralnet,9,0,36,1,0,46,19.56521739
383,MathArithmeticException,org.apache.commons.math3.exception,3,0,1,1,0,5,60
384,MathArrays,org.apache.commons.math3.util,518,0,37,65,1,621,83.57487923
385,MathIllegalArgumentException,org.apache.commons.math3.exception,3,0,1,0,0,4,75
386,MathIllegalNumberException,org.apache.commons.math3.exception,1,0,0,0,0,1,100
387,MathIllegalStateException,org.apache.commons.math3.exception,2,0,2,1,0,5,40
388,MathInternalError,org.apache.commons.math3.exception,0,0,1,0,0,1,0
389,MathParseException,org.apache.commons.math3.exception,0,0,1,1,0,2,0
390,MathRuntimeException,org.apache.commons.math3.exception,0,0,4,0,0,4,0
391,MathUnsupportedOperationException,org.apache.commons.math3.exception,0,0,3,1,0,4,0
392,MathUtils,org.apache.commons.math3.util,54,0,3,27,1,85,64.70588235
393,MatrixDimensionMismatchException,org.apache.commons.math3.linear,4,0,0,0,0,4,100
394,MatrixUtils,org.apache.commons.math3.linear,176,0,13,22,0,211,83.41232227
395,Max,org.apache.commons.math3.analysis.function,1,0,0,0,0,1,100
396,Max,org.apache.commons.math3.stat.descriptive.rank,15,0,1,5,0,21,71.42857143
397,MaxCountExceededException,org.apache.commons.math3.exception,2,0,0,0,0,2,100
398,MaxEval,org.apache.commons.math3.optim,2,0,1,1,0,4,50
399,MaxIter,org.apache.commons.math3.optim,2,0,1,1,0,4,50
400,Mean,org.apache.commons.math3.stat.descriptive.moment,27,0,2,9,0,38,71.05263158
401,Median,org.apache.commons.math3.stat.descriptive.rank,2,0,1,0,0,3,66.66666667
402,MedianOf3PivotingStrategy,org.apache.commons.math3.util,12,0,0,7,0,19,63.15789474
403,MersenneTwister,org.apache.commons.math3.random,104,0,2,7,2,115,92.17391304
404,MicrosphereInterpolatingFunction,org.apache.commons.math3.analysis.interpolation,26,0,0,7,1,34,79.41176471
405,MicrosphereInterpolator,org.apache.commons.math3.analysis.interpolation,3,0,0,2,0,5,60
406,MicrosphereProjectionInterpolator,org.apache.commons.math3.analysis.interpolation,9,0,0,2,0,11,81.81818182
407,MidPointIntegrator,org.apache.commons.math3.analysis.integration,25,0,0,7,2,34,79.41176471
408,MidpointFieldIntegrator,org.apache.commons.math3.ode.nonstiff,4,0,0,0,0,4,100
409,MidpointFieldStepInterpolator,org.apache.commons.math3.ode.nonstiff,4,0,0,1,0,5,80
410,MidpointStepInterpolator,org.apache.commons.math3.ode.nonstiff,29,0,0,1,0,30,96.66666667
411,MillerUpdatingRegression,org.apache.commons.math3.stat.regression,461,0,61,120,0,642,71.80685358
412,Min,org.apache.commons.math3.analysis.function,1,0,0,0,0,1,100
413,Min,org.apache.commons.math3.stat.descriptive.rank,15,0,1,5,0,21,71.42857143
414,Minus,org.apache.commons.math3.analysis.function,3,0,1,0,0,4,75
415,MixtureMultivariateNormalDistribution,org.apache.commons.math3.distribution,3,0,0,0,0,3,100
416,MixtureMultivariateRealDistribution,org.apache.commons.math3.distribution,30,0,1,3,0,34,88.23529412
417,ModelFunction,org.apache.commons.math3.optim.nonlinear.vector,1,0,0,0,0,1,100
418,ModelFunctionJacobian,org.apache.commons.math3.optim.nonlinear.vector,1,0,0,0,0,1,100
419,MonotoneChain,org.apache.commons.math3.geometry.euclidean.twod.hull,38,0,0,9,0,47,80.85106383
420,MullerSolver,org.apache.commons.math3.analysis.solvers,47,0,3,28,0,78,60.25641026
421,MullerSolver2,org.apache.commons.math3.analysis.solvers,46,0,5,12,2,65,73.84615385
422,MultiDimensionMismatchException,org.apache.commons.math3.exception,2,0,2,0,0,4,50
423,MultiDirectionalSimplex,org.apache.commons.math3.optim.nonlinear.scalar.noderiv,16,0,0,1,1,18,94.44444444
424,MultiDirectionalSimplex,org.apache.commons.math3.optimization.direct,16,0,0,1,1,18,94.44444444
425,MultiKMeansPlusPlusClusterer,org.apache.commons.math3.ml.clustering,3,0,3,1,1,8,50
426,MultiStartMultivariateOptimizer,org.apache.commons.math3.optim.nonlinear.scalar,7,0,3,1,0,11,63.63636364
427,MultiStartMultivariateVectorOptimizer,org.apache.commons.math3.optim.nonlinear.vector,2,0,3,6,0,11,18.18181818
428,MultiStartUnivariateOptimizer,org.apache.commons.math3.optim.univariate,27,0,1,4,0,32,84.375
429,MultidimensionalCounter,org.apache.commons.math3.util,54,0,6,2,3,65,87.69230769
430,Multiply,org.apache.commons.math3.analysis.function,2,0,0,0,0,2,100
431,MultistepFieldIntegrator,org.apache.commons.math3.ode,26,0,5,10,2,43,65.11627907
432,MultistepIntegrator,org.apache.commons.math3.ode,26,0,12,12,3,53,54.71698113
433,MultivariateFunctionMappingAdapter,org.apache.commons.math3.optim.nonlinear.scalar,23,0,0,10,0,33,69.6969697
434,MultivariateFunctionMappingAdapter,org.apache.commons.math3.optimization.direct,23,0,0,10,0,33,69.6969697
435,MultivariateFunctionPenaltyAdapter,org.apache.commons.math3.optim.nonlinear.scalar,21,0,0,9,0,30,70
436,MultivariateFunctionPenaltyAdapter,org.apache.commons.math3.optimization.direct,21,0,0,9,0,30,70
437,MultivariateNormalDistribution,org.apache.commons.math3.distribution,40,0,4,3,0,47,85.10638298
438,MultivariateNormalMixtureExpectationMaximization,org.apache.commons.math3.distribution.fitting,90,0,6,11,0,107,84.11214953
439,MultivariateOptimizer,org.apache.commons.math3.optim.nonlinear.scalar,7,0,0,0,0,7,100
440,MultivariateSummaryStatistics,org.apache.commons.math3.stat.descriptive,95,0,0,22,0,117,81.1965812
441,MultivariateVectorOptimizer,org.apache.commons.math3.optim.nonlinear.vector,11,0,0,0,1,12,100
442,NPointCrossover,org.apache.commons.math3.genetics,21,0,1,2,0,24,87.5
443,NakagamiDistribution,org.apache.commons.math3.distribution,26,0,0,17,1,44,61.36363636
444,NaturalRanking,org.apache.commons.math3.stat.ranking,66,0,1,4,0,71,92.95774648
445,NeighbourhoodSizeFunctionFactory,org.apache.commons.math3.ml.neuralnet.sofm,4,0,0,0,0,4,100
446,NelderMeadSimplex,org.apache.commons.math3.optim.nonlinear.scalar.noderiv,62,0,0,5,0,67,92.53731343
447,NelderMeadSimplex,org.apache.commons.math3.optimization.direct,62,0,0,5,0,67,92.53731343
448,NestedLoops,org.apache.commons.math3.geometry.euclidean.twod,0,0,21,0,0,21,0
449,Network,org.apache.commons.math3.ml.neuralnet,38,0,1,6,0,45,84.44444444
450,Neuron,org.apache.commons.math3.ml.neuralnet,21,0,0,2,0,23,91.30434783
451,NeuronSquareMesh2D,org.apache.commons.math3.ml.neuralnet.twod,155,0,7,5,0,167,92.81437126
452,NeuronString,org.apache.commons.math3.ml.neuralnet.oned,40,0,2,3,0,45,88.88888889
453,NevilleInterpolator,org.apache.commons.math3.analysis.interpolation,1,0,0,0,0,1,100
454,NewtonRaphsonSolver,org.apache.commons.math3.analysis.solvers,6,0,0,1,0,7,85.71428571
455,NewtonSolver,org.apache.commons.math3.analysis.solvers,6,0,0,1,0,7,85.71428571
456,NoBracketingException,org.apache.commons.math3.exception,0,0,4,0,0,4,0
457,NodesSet,org.apache.commons.math3.geometry.partitioning,3,0,0,0,0,3,100
458,NonLinearConjugateGradientOptimizer,org.apache.commons.math3.optim.nonlinear.scalar.gradient,44,0,2,1,0,47,93.61702128
459,NonLinearConjugateGradientOptimizer,org.apache.commons.math3.optimization.general,54,0,3,5,1,63,87.3015873
460,NonMonotonicSequenceException,org.apache.commons.math3.exception,4,0,0,4,0,8,50
461,NonNegativeConstraint,org.apache.commons.math3.optim.linear,1,0,0,0,0,1,100
462,NonPositiveDefiniteMatrixException,org.apache.commons.math3.linear,0,0,3,2,0,5,0
463,NonSymmetricMatrixException,org.apache.commons.math3.linear,0,0,3,0,0,3,0
464,NordsieckStepInterpolator,org.apache.commons.math3.ode.sampling,46,0,3,3,13,65,90.76923077
465,NormalApproximationInterval,org.apache.commons.math3.stat.interval,13,0,0,0,0,13,100
466,NormalDistribution,org.apache.commons.math3.distribution,51,0,2,4,0,57,89.47368421
467,NumberIsTooLargeException,org.apache.commons.math3.exception,2,0,0,1,0,3,66.66666667
468,NumberIsTooSmallException,org.apache.commons.math3.exception,2,0,0,1,0,3,66.66666667
469,OLSMultipleLinearRegression,org.apache.commons.math3.stat.regression,40,0,0,0,0,40,100
470,ObjectiveFunction,org.apache.commons.math3.optim.nonlinear.scalar,1,0,0,0,0,1,100
471,ObjectiveFunctionGradient,org.apache.commons.math3.optim.nonlinear.scalar,1,0,0,0,0,1,100
472,OnePointCrossover,org.apache.commons.math3.genetics,13,0,0,0,0,13,100
473,OneWayAnova,org.apache.commons.math3.stat.inference,33,0,0,7,0,40,82.5
474,OpenIntToDoubleHashMap,org.apache.commons.math3.util,101,3,0,26,6,136,80.88235294
475,OpenIntToFieldHashMap,org.apache.commons.math3.util,100,0,1,28,8,137,78.83211679
476,OpenMapRealMatrix,org.apache.commons.math3.linear,53,0,9,7,1,70,77.14285714
477,OpenMapRealVector,org.apache.commons.math3.linear,175,0,19,26,0,220,79.54545455
478,OptimumImpl,org.apache.commons.math3.fitting.leastsquares,7,0,2,0,0,9,77.77777778
479,OrderedCrossover,org.apache.commons.math3.genetics,12,0,0,5,0,17,70.58823529
480,OrderedTuple,org.apache.commons.math3.geometry.partitioning.utilities,0,0,144,0,0,144,0
481,OrientedPoint,org.apache.commons.math3.geometry.euclidean.oned,11,0,5,0,0,16,68.75
482,OutOfRangeException,org.apache.commons.math3.exception,2,0,0,0,0,2,100
483,OutlineExtractor,org.apache.commons.math3.geometry.euclidean.threed,0,0,84,0,0,84,0
484,PSquarePercentile,org.apache.commons.math3.stat.descriptive.rank,163,0,0,22,0,185,88.10810811
485,Pair,org.apache.commons.math3.util,19,0,1,5,0,25,76
486,ParameterConfiguration,org.apache.commons.math3.ode,1,0,0,1,0,2,50
487,ParameterJacobianWrapper,org.apache.commons.math3.ode,12,0,2,0,0,14,85.71428571
488,ParameterizedWrapper,org.apache.commons.math3.ode,0,0,6,0,0,6,0
489,ParetoDistribution,org.apache.commons.math3.distribution,49,0,0,6,1,56,89.28571429
490,PascalDistribution,org.apache.commons.math3.distribution,42,0,1,1,0,44,95.45454545
491,PearsonsCorrelation,org.apache.commons.math3.stat.correlation,60,0,0,4,0,64,93.75
492,Percentile,org.apache.commons.math3.stat.descriptive.rank,156,0,4,25,0,185,84.32432432
493,PiecewiseBicubicSplineInterpolatingFunction,org.apache.commons.math3.analysis.interpolation,48,0,13,3,0,64,75
494,PiecewiseBicubicSplineInterpolator,org.apache.commons.math3.analysis.interpolation,8,0,0,2,0,10,80
495,Plane,org.apache.commons.math3.geometry.euclidean.threed,107,0,8,12,0,127,84.2519685
496,PointValuePair,org.apache.commons.math3.optim,6,0,0,1,0,7,85.71428571
497,PointValuePair,org.apache.commons.math3.optimization,6,0,0,1,0,7,85.71428571
498,PointVectorValuePair,org.apache.commons.math3.optim,10,0,0,2,0,12,83.33333333
499,PointVectorValuePair,org.apache.commons.math3.optimization,10,0,0,2,0,12,83.33333333
500,PoissonDistribution,org.apache.commons.math3.distribution,99,0,3,32,2,136,74.26470588
501,PollardRho,org.apache.commons.math3.primes,0,0,43,0,0,43,0
502,PolygonsSet,org.apache.commons.math3.geometry.euclidean.twod,138,0,31,52,6,227,63.43612335
503,PolyhedronsSet,org.apache.commons.math3.geometry.euclidean.threed,99,0,8,27,0,134,73.88059701
504,PolynomialCurveFitter,org.apache.commons.math3.fitting,6,0,1,0,0,7,85.71428571
505,PolynomialFitter,org.apache.commons.math3.fitting,1,0,1,0,0,2,50
506,PolynomialFitter,org.apache.commons.math3.optimization.fitting,1,0,3,0,0,4,25
507,PolynomialFunction,org.apache.commons.math3.analysis.polynomials,87,0,23,11,0,121,71.90082645
508,PolynomialFunctionLagrangeForm,org.apache.commons.math3.analysis.polynomials,83,0,10,6,0,99,83.83838384
509,PolynomialFunctionNewtonForm,org.apache.commons.math3.analysis.polynomials,41,0,4,6,0,51,80.39215686
510,PolynomialSplineFunction,org.apache.commons.math3.analysis.polynomials,43,0,12,0,0,55,78.18181818
511,PolynomialsUtils,org.apache.commons.math3.analysis.polynomials,95,0,1,10,0,106,89.62264151
512,Pow,org.apache.commons.math3.analysis.function,1,0,0,0,0,1,100
513,PowellOptimizer,org.apache.commons.math3.optim.nonlinear.scalar.noderiv,34,0,0,30,0,64,53.125
514,PowellOptimizer,org.apache.commons.math3.optimization.direct,38,0,0,31,0,69,55.07246377
515,Power,org.apache.commons.math3.analysis.function,2,0,1,0,0,3,66.66666667
516,Precision,org.apache.commons.math3.util,116,0,19,17,0,152,76.31578947
517,PreconditionedIterativeLinearSolver,org.apache.commons.math3.linear,8,0,2,4,0,14,57.14285714
518,Primes,org.apache.commons.math3.primes,31,0,0,1,0,32,96.875
519,Product,org.apache.commons.math3.stat.descriptive.summary,21,0,1,3,0,25,84
520,ProperBigFractionFormat,org.apache.commons.math3.fraction,26,0,6,8,0,40,65
521,ProperFractionFormat,org.apache.commons.math3.fraction,26,0,6,7,0,39,66.66666667
522,PropertiesComputer,org.apache.commons.math3.geometry.spherical.twod,20,0,2,3,0,25,80
523,QRDecomposition,org.apache.commons.math3.linear,170,0,0,4,0,174,97.70114943
524,QuantizationError,org.apache.commons.math3.ml.neuralnet.twod.util,0,0,11,0,0,11,0
525,QuasiSigmoidDecayFunction,org.apache.commons.math3.ml.neuralnet.sofm.util,10,0,0,1,0,11,90.90909091
526,Quaternion,org.apache.commons.math3.complex,121,0,4,7,0,132,91.66666667
527,RRQRDecomposition,org.apache.commons.math3.linear,24,0,0,12,0,36,66.66666667
528,RandomAdaptor,org.apache.commons.math3.random,9,0,4,2,0,15,60
529,RandomDataGenerator,org.apache.commons.math3.random,78,0,23,26,9,136,63.97058824
530,RandomDataImpl,org.apache.commons.math3.random,0,0,31,1,0,32,0
531,RandomGeneratorFactory,org.apache.commons.math3.random,10,0,4,2,1,17,64.70588235
532,RandomKey,org.apache.commons.math3.genetics,38,0,2,1,3,44,93.18181818
533,RandomKeyMutation,org.apache.commons.math3.genetics,2,0,0,0,0,2,100
534,RandomPivotingStrategy,org.apache.commons.math3.util,0,0,5,0,0,5,0
535,RealLinearOperator,org.apache.commons.math3.linear,0,0,1,0,0,1,0
536,RealMatrixFormat,org.apache.commons.math3.linear,44,0,11,5,0,60,73.33333333
537,RealVector,org.apache.commons.math3.linear,201,0,2,30,1,234,86.32478632
538,RealVectorFormat,org.apache.commons.math3.linear,28,0,4,2,1,35,82.85714286
539,RectangularCholeskyDecomposition,org.apache.commons.math3.linear,46,0,0,2,0,48,95.83333333
540,RegionFactory,org.apache.commons.math3.geometry.partitioning,43,0,5,13,0,61,70.49180328
541,RegressionResults,org.apache.commons.math3.stat.regression,65,0,24,15,0,104,62.5
542,Relationship,org.apache.commons.math3.optim.linear,2,0,1,1,0,4,50
543,Relationship,org.apache.commons.math3.optimization.linear,2,0,1,1,0,4,50
544,ResizableDoubleArray,org.apache.commons.math3.util,111,0,6,32,0,149,74.4966443
545,RiddersSolver,org.apache.commons.math3.analysis.solvers,21,0,4,8,0,33,63.63636364
546,Rint,org.apache.commons.math3.analysis.function,0,0,0,1,0,1,0
547,RombergIntegrator,org.apache.commons.math3.analysis.integration,21,0,2,6,0,29,72.4137931
548,RootsOfUnity,org.apache.commons.math3.complex,30,0,2,5,0,37,81.08108108
549,Rotation,org.apache.commons.math3.geometry.euclidean.threed,641,0,0,85,0,726,88.29201102
550,RotationOrder,org.apache.commons.math3.geometry.euclidean.threed,4,0,0,0,0,4,100
551,RungeKuttaFieldIntegrator,org.apache.commons.math3.ode.nonstiff,53,0,1,8,6,68,86.76470588
552,RungeKuttaFieldStepInterpolator,org.apache.commons.math3.ode.nonstiff,12,0,0,0,0,12,100
553,RungeKuttaIntegrator,org.apache.commons.math3.ode.nonstiff,93,0,1,11,5,110,89.09090909
554,RungeKuttaStepInterpolator,org.apache.commons.math3.ode.nonstiff,33,0,0,5,0,38,86.84210526
555,S1Point,org.apache.commons.math3.geometry.spherical.oned,14,0,1,4,0,19,73.68421053
556,S2Point,org.apache.commons.math3.geometry.spherical.twod,26,0,1,9,0,36,72.22222222
557,SaddlePointExpansion,org.apache.commons.math3.distribution,51,0,6,14,5,76,73.68421053
558,SchurTransformer,org.apache.commons.math3.linear,245,0,0,38,2,285,86.66666667
559,SearchInterval,org.apache.commons.math3.optim.univariate,9,0,0,2,0,11,81.81818182
560,SecantSolver,org.apache.commons.math3.analysis.solvers,16,0,1,3,0,20,80
561,SecondMoment,org.apache.commons.math3.stat.descriptive.moment,12,0,0,2,0,14,85.71428571
562,Segment,org.apache.commons.math3.geometry.euclidean.threed,3,0,0,0,0,3,100
563,Segment,org.apache.commons.math3.geometry.euclidean.twod,21,0,1,2,0,24,87.5
564,SemiVariance,org.apache.commons.math3.stat.descriptive.moment,21,0,10,1,0,32,65.625
565,Sigmoid,org.apache.commons.math3.analysis.function,46,0,1,1,0,48,95.83333333
566,Signum,org.apache.commons.math3.analysis.function,0,0,0,1,0,1,0
567,SimpleBounds,org.apache.commons.math3.optim,5,0,0,0,0,5,100
568,SimpleBounds,org.apache.commons.math3.optimization,2,0,0,0,0,2,100
569,SimpleCurveFitter,org.apache.commons.math3.fitting,3,0,2,0,0,5,60
570,SimplePointChecker,org.apache.commons.math3.optim,14,0,0,2,0,16,87.5
571,SimplePointChecker,org.apache.commons.math3.optimization,14,0,0,2,0,16,87.5
572,SimpleRegression,org.apache.commons.math3.stat.regression,218,0,48,23,0,289,75.43252595
573,SimpleUnivariateValueChecker,org.apache.commons.math3.optim.univariate,12,0,0,2,0,14,85.71428571
574,SimpleUnivariateValueChecker,org.apache.commons.math3.optimization.univariate,12,0,0,2,0,14,85.71428571
575,SimpleValueChecker,org.apache.commons.math3.optim,12,0,0,2,0,14,85.71428571
576,SimpleValueChecker,org.apache.commons.math3.optimization,12,0,0,2,0,14,85.71428571
577,SimpleVectorValueChecker,org.apache.commons.math3.optim,14,0,0,2,0,16,87.5
578,SimpleVectorValueChecker,org.apache.commons.math3.optimization,14,0,0,2,0,16,87.5
579,SimplexOptimizer,org.apache.commons.math3.optim.nonlinear.scalar.noderiv,24,0,0,0,0,24,100
580,SimplexOptimizer,org.apache.commons.math3.optimization.direct,21,0,0,1,0,22,95.45454545
581,SimplexSolver,org.apache.commons.math3.optim.linear,46,0,1,14,7,68,77.94117647
582,SimplexSolver,org.apache.commons.math3.optimization.linear,42,0,0,15,3,60,75
583,SimplexTableau,org.apache.commons.math3.optim.linear,174,0,13,11,2,200,88
584,SimplexTableau,org.apache.commons.math3.optimization.linear,159,0,13,12,2,186,86.55913978
585,SimpsonIntegrator,org.apache.commons.math3.analysis.integration,13,0,6,5,0,24,54.16666667
586,Sin,org.apache.commons.math3.analysis.function,3,0,0,0,0,3,100
587,Sinc,org.apache.commons.math3.analysis.function,75,0,1,21,0,97,77.31958763
588,SingularValueDecomposition,org.apache.commons.math3.linear,367,0,2,66,11,446,84.75336323
589,Sinh,org.apache.commons.math3.analysis.function,0,0,2,1,0,3,0
590,Skewness,org.apache.commons.math3.stat.descriptive.moment,48,0,1,10,0,59,81.3559322
591,SmallPrimes,org.apache.commons.math3.primes,28,0,2,13,2,45,66.66666667
592,SmoothedDataHistogram,org.apache.commons.math3.ml.neuralnet.twod.util,0,0,16,0,0,16,0
593,SmoothingPolynomialBicubicSplineInterpolator,org.apache.commons.math3.analysis.interpolation,43,0,0,4,0,47,91.4893617
594,SobolSequenceGenerator,org.apache.commons.math3.random,72,0,1,16,0,89,80.8988764
595,SolutionCallback,org.apache.commons.math3.optim.linear,4,0,0,0,0,4,100
596,SparseFieldMatrix,org.apache.commons.math3.linear,8,0,13,5,0,26,30.76923077
597,SparseFieldVector,org.apache.commons.math3.linear,119,0,66,42,0,227,52.42290749
598,SparseGradient,org.apache.commons.math3.analysis.differentiation,223,0,5,22,0,250,89.2
599,SpearmansCorrelation,org.apache.commons.math3.stat.correlation,34,0,2,1,0,37,91.89189189
600,Sphere1D,org.apache.commons.math3.geometry.spherical.oned,3,0,0,0,0,3,100
601,Sphere2D,org.apache.commons.math3.geometry.spherical.twod,3,0,1,0,0,4,75
602,SphereGenerator,org.apache.commons.math3.geometry.euclidean.threed,15,0,0,3,0,18,83.33333333
603,SphericalCoordinates,org.apache.commons.math3.geometry.euclidean.threed,204,0,0,0,0,204,100
604,SphericalPolygonsSet,org.apache.commons.math3.geometry.spherical.twod,72,0,5,13,4,94,80.85106383
605,SplineInterpolator,org.apache.commons.math3.analysis.interpolation,67,0,0,1,0,68,98.52941176
606,Sqrt,org.apache.commons.math3.analysis.function,2,0,1,0,0,3,66.66666667
607,StableRandomGenerator,org.apache.commons.math3.random,21,0,23,19,0,63,33.33333333
608,StandardDeviation,org.apache.commons.math3.stat.descriptive.moment,9,0,4,3,0,16,56.25
609,StatUtils,org.apache.commons.math3.stat,65,0,8,7,0,80,81.25
610,StatisticalSummaryValues,org.apache.commons.math3.stat.descriptive,20,0,0,12,0,32,62.5
611,StepFunction,org.apache.commons.math3.analysis.function,12,0,0,1,0,13,92.30769231
612,StepNormalizer,org.apache.commons.math3.ode.sampling,23,0,1,7,8,39,79.48717949
613,StepNormalizerBounds,org.apache.commons.math3.ode.sampling,2,0,0,0,0,2,100
614,StorelessBivariateCovariance,org.apache.commons.math3.stat.correlation,32,0,3,1,0,36,88.88888889
615,StorelessCovariance,org.apache.commons.math3.stat.correlation,36,0,9,3,0,48,75
616,SubCircle,org.apache.commons.math3.geometry.spherical.twod,8,0,0,2,0,10,80
617,SubHyperplane,org.apache.commons.math3.geometry.partitioning,12,0,0,0,0,12,100
618,SubLimitAngle,org.apache.commons.math3.geometry.spherical.oned,4,0,0,2,0,6,66.66666667
619,SubLine,org.apache.commons.math3.geometry.euclidean.threed,11,0,0,0,0,11,100
620,SubLine,org.apache.commons.math3.geometry.euclidean.twod,25,0,0,3,0,28,89.28571429
621,SubOrientedPoint,org.apache.commons.math3.geometry.euclidean.oned,7,0,1,2,0,10,70
622,SubPlane,org.apache.commons.math3.geometry.euclidean.threed,12,0,0,3,0,15,80
623,Subtract,org.apache.commons.math3.analysis.function,0,0,2,0,0,2,0
624,Sum,org.apache.commons.math3.stat.descriptive.summary,21,0,2,3,0,26,80.76923077
625,SumOfClusterVariances,org.apache.commons.math3.ml.clustering.evaluation,5,0,0,0,0,5,100
626,SumOfLogs,org.apache.commons.math3.stat.descriptive.summary,13,0,1,3,0,17,76.47058824
627,SumOfSquares,org.apache.commons.math3.stat.descriptive.summary,15,0,1,3,0,19,78.94736842
628,SummaryStatistics,org.apache.commons.math3.stat.descriptive,66,0,18,38,0,122,54.09836066
629,SymmLQ,org.apache.commons.math3.linear,158,0,10,47,0,215,73.48837209
630,SymmetricGaussIntegrator,org.apache.commons.math3.analysis.integration.gauss,18,0,0,2,0,20,90
631,SynchronizedDescriptiveStatistics,org.apache.commons.math3.stat.descriptive,13,0,2,2,0,17,76.47058824
632,SynchronizedMultivariateSummaryStatistics,org.apache.commons.math3.stat.descriptive,30,0,0,0,0,30,100
633,SynchronizedRandomGenerator,org.apache.commons.math3.random,8,0,3,0,0,11,72.72727273
634,SynchronizedSummaryStatistics,org.apache.commons.math3.stat.descriptive,22,0,16,1,0,39,56.41025641
635,TDistribution,org.apache.commons.math3.distribution,45,0,0,5,1,51,90.19607843
636,TTest,org.apache.commons.math3.stat.inference,106,0,3,24,0,133,79.69924812
637,Tan,org.apache.commons.math3.analysis.function,0,0,2,1,0,3,0
638,Tanh,org.apache.commons.math3.analysis.function,0,0,2,1,0,3,0
639,Target,org.apache.commons.math3.optim.nonlinear.vector,1,0,0,0,0,1,100
640,Target,org.apache.commons.math3.optimization,1,0,0,0,0,1,100
641,TestUtils,org.apache.commons.math3.stat.inference,39,0,11,0,0,50,78
642,ThirdMoment,org.apache.commons.math3.stat.descriptive.moment,19,0,0,2,0,21,90.47619048
643,ThreeEighthesFieldIntegrator,org.apache.commons.math3.ode.nonstiff,7,0,0,0,0,7,100
644,ThreeEighthesFieldStepInterpolator,org.apache.commons.math3.ode.nonstiff,5,0,0,0,0,5,100
645,ThreeEighthesStepInterpolator,org.apache.commons.math3.ode.nonstiff,85,0,0,0,0,85,100
646,TooManyEvaluationsException,org.apache.commons.math3.exception,0,0,0,1,0,1,0
647,TooManyIterationsException,org.apache.commons.math3.exception,0,0,0,1,0,1,0
648,TopographicErrorHistogram,org.apache.commons.math3.ml.neuralnet.twod.util,0,0,12,0,0,12,0
649,TournamentSelection,org.apache.commons.math3.genetics,7,0,2,1,0,10,70
650,TransformUtils,org.apache.commons.math3.transform,17,0,3,1,0,21,80.95238095
651,Transformer,org.apache.commons.math3.ode.events,8,0,0,1,0,9,88.88888889
652,TransformerMap,org.apache.commons.math3.util,16,0,8,2,0,26,61.53846154
653,TrapezoidIntegrator,org.apache.commons.math3.analysis.integration,31,0,2,5,0,38,81.57894737
654,TriDiagonalTransformer,org.apache.commons.math3.linear,120,0,1,3,0,124,96.77419355
655,TriangularDistribution,org.apache.commons.math3.distribution,106,0,3,11,0,120,88.33333333
656,TricubicInterpolatingFunction,org.apache.commons.math3.analysis.interpolation,187,0,22,1,0,210,89.04761905
657,TricubicInterpolator,org.apache.commons.math3.analysis.interpolation,56,0,17,6,0,79,70.88607595
658,TricubicSplineInterpolatingFunction,org.apache.commons.math3.analysis.interpolation,117,0,5,8,0,130,90
659,TricubicSplineInterpolator,org.apache.commons.math3.analysis.interpolation,52,0,0,35,0,87,59.77011494
660,Ulp,org.apache.commons.math3.analysis.function,0,0,0,1,0,1,0
661,UncorrelatedRandomVectorGenerator,org.apache.commons.math3.random,7,0,0,0,0,7,100
662,UnifiedDistanceMatrix,org.apache.commons.math3.ml.neuralnet.twod.util,0,0,54,0,0,54,0
663,UniformCrossover,org.apache.commons.math3.genetics,14,0,1,0,0,15,93.33333333
664,UniformIntegerDistribution,org.apache.commons.math3.distribution,39,0,1,3,3,46,91.30434783
665,UniformRandomGenerator,org.apache.commons.math3.random,4,0,0,0,0,4,100
666,UniformRealDistribution,org.apache.commons.math3.distribution,41,0,1,3,0,45,91.11111111
667,UnitSphereRandomVectorGenerator,org.apache.commons.math3.random,11,0,0,0,0,11,100
668,UnivariateMultiStartOptimizer,org.apache.commons.math3.optimization.univariate,26,0,3,4,0,33,78.78787879
669,UnivariateObjectiveFunction,org.apache.commons.math3.optim.univariate,1,0,0,0,0,1,100
670,UnivariateOptimizer,org.apache.commons.math3.optim.univariate,11,0,0,0,0,11,100
671,UnivariatePeriodicInterpolator,org.apache.commons.math3.analysis.interpolation,18,0,0,3,0,21,85.71428571
672,UnivariatePointValuePair,org.apache.commons.math3.optim.univariate,2,0,0,0,0,2,100
673,UnivariatePointValuePair,org.apache.commons.math3.optimization.univariate,2,0,0,0,0,2,100
674,UnivariateSolverUtils,org.apache.commons.math3.analysis.solvers,53,0,16,26,0,95,55.78947368
675,UnknownParameterException,org.apache.commons.math3.ode,1,0,0,0,0,1,100
676,ValueServer,org.apache.commons.math3.random,31,0,1,6,0,38,81.57894737
677,Variance,org.apache.commons.math3.stat.descriptive.moment,67,0,7,18,0,92,72.82608696
678,Vector1D,org.apache.commons.math3.geometry.euclidean.oned,69,0,3,4,0,76,90.78947368
679,Vector1DFormat,org.apache.commons.math3.geometry.euclidean.oned,8,0,0,0,0,8,100
680,Vector2D,org.apache.commons.math3.geometry.euclidean.twod,41,0,92,16,0,149,27.51677852
681,Vector2DFormat,org.apache.commons.math3.geometry.euclidean.twod,7,0,1,0,0,8,87.5
682,Vector3D,org.apache.commons.math3.geometry.euclidean.threed,157,0,0,15,0,172,91.27906977
683,Vector3DFormat,org.apache.commons.math3.geometry.euclidean.threed,8,0,0,0,0,8,100
684,VectorFormat,org.apache.commons.math3.geometry,24,0,6,2,0,32,75
685,VectorialCovariance,org.apache.commons.math3.stat.descriptive.moment,39,0,18,6,0,63,61.9047619
686,VectorialMean,org.apache.commons.math3.stat.descriptive.moment,15,0,6,1,0,22,68.18181818
687,Vertex,org.apache.commons.math3.geometry.spherical.twod,6,0,1,2,0,9,66.66666667
688,WeibullDistribution,org.apache.commons.math3.distribution,57,0,4,5,0,66,86.36363636
689,Weight,org.apache.commons.math3.optim.nonlinear.vector,1,0,1,0,0,2,50
690,Weight,org.apache.commons.math3.optimization,1,0,1,0,0,2,50
691,WeightedObservedPoint,org.apache.commons.math3.fitting,3,0,0,0,0,3,100
692,WeightedObservedPoint,org.apache.commons.math3.optimization.fitting,3,0,0,0,0,3,100
693,WeightedObservedPoints,org.apache.commons.math3.fitting,3,0,0,0,0,3,100
694,Well1024a,org.apache.commons.math3.random,20,0,0,0,0,20,100
695,Well19937a,org.apache.commons.math3.random,26,0,0,0,0,26,100
696,Well19937c,org.apache.commons.math3.random,32,0,0,0,0,32,100
697,Well44497a,org.apache.commons.math3.random,29,0,0,0,0,29,100
698,Well44497b,org.apache.commons.math3.random,35,0,0,0,0,35,100
699,Well512a,org.apache.commons.math3.random,22,0,0,0,0,22,100
700,WelzlEncloser,org.apache.commons.math3.geometry.enclosing,19,0,0,5,4,28,82.14285714
701,WilcoxonSignedRankTest,org.apache.commons.math3.stat.inference,57,0,0,7,2,66,89.39393939
702,WilsonScoreInterval,org.apache.commons.math3.stat.interval,27,0,0,0,0,27,100
703,ZipfDistribution,org.apache.commons.math3.distribution,83,0,1,26,4,114,76.31578947